--- 1 ---
水 - shuǐ - вода\река\водоем\жидкость
大 - dà - взрослый\самый старший\большой
小 - xiǎo - маленький\небольшой\недолго\слегка
多 - duō - много\большое количество\побольше\быть намного больше (чем ожидалось)
少 - shǎo - недоставать\не хватать\мало\немного\недолго
高 - gāo - высокий
山 - shān - гора\холм
日 - rì - день\дата
月 - yuè - месяц\месячный\луна
 云 - yún - облако
风 - fēng - ветер\продувать\сушить на ветру
雨 - yǔ - дождь
 土 - tǔ - почва\земля\территория
 木 - mù - дерево\древесина\гроб\простой\бесхитростный
--- 2 ---
零 - líng - ноль
一 - yī - один\одинаковый\весь\целый
二 - èr - два
两 - liǎng - два\оба\пара
三 - sān - три
四 - sì - четыре
 五 - wǔ - пять
六 - liù - шесть
 七 - qī - семь
八 - bā - восемь
 九 - jiǔ - девять
十 - shí - десять
百 - bǎi - сотня\много\множество
 千 - qiān - тысяча\огромное количество
 万 - wàn - десять тысяч
--- 3 ---
上 - shàng - прошлый\предыдущий\вышестоящий\вверху
下 - xià - следующий\низ\внизу
 左 - zuǒ - левый\(полит.)революционный
 右 - yòu - правый\(полит.)консервативный
 北 - běi - север
 南 - nán - юг
 西 - xī - запад
 东 - dōng - восток
边 - biān - сторона\граница
面 - miàn - сторона\поверхность
--- 4 ---
 亮 - liàng - яркий\светлый\(о голосе)звонкий\сверкать
 明 - míng - яркий\завтра или будущий год
 天 - tiān - небо\день\погода
羊 - yáng - овца\баран
中 - zhōng - середина\центр\внутри
国 - guó - государство\страна\нация
我 - wǒ - я
 你 - nǐ - ты
 他 - tā - он
她 - tā - она
 也 - yě - также\тоже\и\даже
女 -  nǚ - женщина\дочь\девочка
男 - nán - мужчина\сын\мальчик
 是 - shì - быть\правильный\верный
--- 5 ---
田 - tián - поле\пашня\месторождение
 力 - lì - сила\способность\мощь
火 - huǒ - огонь
牛 - niú - упрямый\высокомерный\корова
肉 - ròu - мясо\плоть\мякоть(фрукта)
鱼 - yú - рыба
--- 6 ---
背 - bèi - спина\спинка\задняя часть
儿子 - ér zi - сын
女儿 - nǚ ér - дочь
姐姐 - jiě jie - старшая сестра
妹妹 - mèi mei - младшая сестра
哥哥 - gē ge - старший брат
弟弟 - dì di - младший брат
妈妈 - mā ma - мама\мать
爸爸 - bà ba - папа\отец
--- 7 ---
耳(朵) - ěr(duo) - ухо
花(朵) - huā(duǒ) - цветок
目 - mù - глаз\статья\каталог\название
眼 - yǎn - глаз\небольшое отверстие
睛 - jīng - глазное яблоко
手 - shǒu - рука\умение\мастерство
足 - zú - нога\ступня\футбол\достаточный\полный
球 - qiú - мяч\шар\сфера
王 - wáng - король\принц\князь\главарь\дедушка\лучший\сильнейший в своем роде
立 - lì - стоять\возвышаться\устанавливать\составлять(документ)
站 - zhàn - стоять\вставать\останавливаться
坐 - zuò - сидеть\путешествовать на...
--- 8 ---
本 - běn - издание\версия\книга\том
吗 - ma - вопросительная частица
作 - zuò - делать\писать\сочинять
--- 9 ---
画 - huà - рисовать\писать красками|картина\рисунок
鸟 - niǎo - птица
不 - bù - не\нет
虫 - chóng - насекомое\червь|(обр.)подлый человек
对 - duì - правильный\верный
--- 10 ---
本 - běn - корень\основа\изначально|издание\версия|книга\том\блокнот
头 - tou - голова\шеф\лидер
钱 - qián - монета\деньги\богатство
个 - ge - (счет всего)
眼睛 - yǎn jing - глаз
草 - cǎo - трава\сено\солома
--- 11 ---
杯 - bēi - кружка\стакан\кубок
了 - le - модальная частица (используется после глагола или прилагательного и означает завершение действия, или в конце предложения и означает изменение ситуации)
很 - hěn - очень\весьма
兴 - xìng - воодушевление\интерес

今 - jīn - настоящее время\ныне\современный\нынешний
明 - míng - завтра или будущий год\яркий\светлый\зрение\зоркий\понимать
昨 - zuó - вчера\прошлое
前 - qián - сепереди\перед\предшествующий\позавчера
后 - hòu - сзади\после\послезватра

春 - chūn - весна
夏 - xià - лето
秋 - qiū - осень\один год\тяжелое время\время сбора урожая\качели
冬 - dōng - зима
--- 12 ---
家 - jiā - семья\дом
在 - zài - в течение\в процессе
那 - nà - тот\те\то
这 - zhè - этот\эти\это\сейчас\в этот момент
哪 - nǎ - который\какой\кто\который бы\какой бы\кто бы
里 - lǐ - окрестности\родина\родные края
文 - wén - письменность\язык
去 - qù - идти\ехать
包 - bāo - пакет\сумка\коробка\оборачивать\окружать
唱 - chàng - петь
歌 - gē - песня\мелодия\петь\хвалить\воспевать
背 - bèi - спина\спинка\задняя часть\нести на спине
朵 - duǒ - иероглиф, используемый в 耳朵\счетное слово для цветов, облаков
难 - nán - трудный\ставить в трудное положение
又 - yòu - снова\опять(о действии, которое продолжается или повторяется)\вдобавок
汉 - hàn - мужчина
白 - bái - белый\белый цвет\светлый
的 - de - используется с прилагательными или атрибутивными фразами; используется для образования существительного; используется для акцентирования субъекта действия, времени или места; используется для придания позитивного тона фразе; ...и т.д.
有 - yǒu - иметь\иметься\быть в наличии
字 - zì - иероглиф\произношение (слова или иероглифа)\имя\квитанция, расписка
--- 13 ---
歌 - gē - песня\мелодия\петь\хвалить\воспевать
 欠 - qiàn - недоставать\зевать\задолжать\быть должным
爷爷 - yé ye - дедушка со стороны отца
外 - wài - внешняя часть
外公 - wài gōng - дед со стороны матери
外婆 - wài pó - бабушка со стороны матери
外语 - wài yǔ - иностранный язык
公 - gōng - самец
雪 - xuě - снег