草 - cǎo - трава\сено\солома
去 - qù - идти\ехать
------------------------------
结束 - jié shù - закончить(ся)\завершить(ся)
------------------------------
红 - hóng - красный
这 - zhè - этот, эти; сейчас, в этот момент
远 - yuǎn - далекий\отдаленный
叫 - jiào - кричать\называть\звать\вызывать
里 - lǐ - окрестности\родина\родные края
房 - fáng - дом\комната
间 - jiān - комната
的 - de - притяжательная частица
感兴趣 - gǎn xìng qù - интересоваться\испытывать интерес
姑娘 - gū niang - девушка
画 - huà - рисовать\писать красками\картина\рисунок
袋子 - dài zi - сумка\мешок
也 - yě - также\тоже\и\даже\даже если
地 - dì - пол
有 - yǒu - иметь\быть в наличии
左 - zuǒ - левый
右 - yòu - правый
在 - zài - в течение\в процессе\в, на

开放 - kāi fàng - быть открытым для\открываться\широких взглядов

冰箱 - bīng xiāng - холодильник
 冰 - лед
 箱 - ящик\чемодан\предмет в форме ящика

ОВОЩИ
西兰花 - xī lán huā - брокколи
茄子 - qié zi - баклажан
西红柿 - xī hóng shì - помидор\(запад красный хурма)
玉米 - yù mǐ - кукуруза\маис
(胡)椒 - (hú) jiāo - перец
蘑菇 - mó gu - гриб
洋葱 - yáng cōng - лук репчатый
胡萝卜 - hú luó bo - морковь\морковка

绿豆 - lǜ dòu - зеленая фасоль
土豆 - tǔ dòu - картофель\[земельная фасоль]

生菜 - shēng cài - салат-латук
白菜 - bái cài - китайская капуста
包菜 - bāo cài - кочанная капуста

南瓜 - nán guā - тыква (юг тыква)
黄瓜 - huáng guā - огурец - (желтый тыква)
西瓜 - xī guā - арбуз - (запад тыква)
哈密瓜 - hā mì guā - хамигуа\хамийская дыня
甜瓜 - tián guā - дыня(слаткая тыква)

ФРУКТЫ
苹果 - píng guǒ - яблоко
梨 - lí - груша
橙子 - chéng zi - апельсин
橘子 - jú zi - мандарин
柠檬 - níng méng - лимон
芒果 - máng guǒ - манго

桃 - táo - персик\грецкий орех\предмет в форме персика
 桃子 - táo zi - персик\нектарин
 猕猴桃 - mí hóu táo - киви
 樱桃 - yīng táo - вишня

菠萝 - bō luó - ананас
香蕉 - xiāng jiāo - банан
葡萄 - pú tao - виноград
草莓 - cǎo méi - клубника\земляника
石榴 - shí liu - гранат
荔枝 - lì zhī - личжи\фрукт любви
蓝莓 - lán méi - голубика


杯 - bēi - кружка\стакан\кубок
坏 - huài - плохой\сломанный\испорченный
怎么了 - zěn me le - в чем дело?\ что случилось?
软 - ruǎn - мягкий\нежный\слабый\легко поддающийся влиянию\нерешительный
刷子 - shuā zi - щетка
坐 - zuò - сидеть\путешествовать на...

请进 - qǐng jìn - пожалуйста\войдите