Тоны
 - 1
 / 2
 ^ 3
 \ 4

chu- ju/ - выйти\уйти
dou- - все\всё\без исключения
快递 - kuài dì - срочная доставка
 递 - dì - давать\передавать
wai\mai\ - еда на вынос\еда с доставкой на дом
jian\ (mian\) - встречаться\свидеться
 jian - встреча
 mian - [счет плоских предметов\встеч]
zhe\ me - настолько\так\такой
 me - [суффикс, не несущий смысловой нагрузки]
xing\ ming/ - полное имя\имя-фамилия
yi\ qi^ - одна группа\одно место\совместно\в компании
全部 - quán bù - все\полностью
 全 - полный\целый\без исключения\полностью
 部 - часть\раздел\отдел\департамент
ji^ ge - несколько\немного\сколько

请 - qǐng - просить\приглашать\пожалуйста(просьба)\приглашаю

wei\ - алло\эй
wei\ shen/ me - почему
 shen/ me - что?
yin- wei\ - потому что
zen^ me [] - почему\как []
 zen^ me le - что случилось\в чем дело
 zen^ me yang\ - как\каким образом\который


xia\ lai/ - спускаться

zuo\ - садиться
jian\ - видеть\встречаться
zhu\ - желать
bu/ cuo\ - хороший\неплохой
dai\ - брать\приносить\носить с собой

jia- fa^ - сложение
 jia- - добавлять
 fa^ - закон
xin- qing/ - настроение\расположение духа
kai- che- - водить автомобиль
帅 - shuài - красивый(о мужчине)
hui\ - уметь
一点(点) - yì dián (diǎn) - немного
 点 - diǎn - час
mang/ - занят
bao- - оборачивать(в обертку\вокруг предмета)
dan\ shi\ - но\однако
zai\ - в(предлог)

gou le - достаточно
gou - достаточный

ci\ - счет повторений(повторений действия)
xiao^ xin- - осторожно
kai che - водить авто
zuo [] - ехать на [машине\самолете\лодке...]\путешествовать на...\ сидеть
qi [] - ехать (верхом) на [велосипеде\мотоцикле\лошади...]
shei/ - кто
gei^ - давать\для\(перед адресатом для дательного падежа)
 da dian hua gei [shei] - говорить по телефону с [кем]
zhi hou - потом
xue shen - студент\школьник
gong- ju\ - инструмент(tool)
hai pa - бояться\испугаться\страшиться

公斤 - gōng jīn - килограмм
 公 - gōng - (о животных)самец\общественный\международный
 斤 - jīn - полкилограмма
克 - kè - грамм

chu- sheng- - момент рождения\появления на свет
zhao\ gu\ - заботиться\ухаживать

zhong\ - выращивать
zheng- (chu-) - выбросить
geng\ - больше\еще больше
gui\ - дорогой\ценный
pian/ yi - дешевый
suo/ yi^ - поэтому
sheng\ - правильный

个子 - gè zi - рост\размер(тела)

wan/ - развлекаться\играть
[] sui\ - [] лет
qu\ guo [] - был\бывал в [каком-либо месте]
hui/ fan^ - (fan hui) - вернуться
hui/ - возвращаться\поворачивать\разворачивать
 hui/ lai/ - возвращаться сюда
 hui/ qu\ - возвращаться туда
 hui dao - вернуться обратно
dao\ - прибывать\добираться\уезжать\отправляться
 dao jia - возвращаться домой
mang/ - занят
shi/ (jian-) - время
shi/ hou - момент времени\период времени
cuo\ - ошибка\неправильный
药 - yào - лекарство\медикаменты\травить
ji\ zhu - запоминать
 ji bu zhu - трудно запоминать
zai [] le - [указывает на момент завершения [] ]

问题 - wèn tí - вопрос\проблема 
 问 - задать вопрос
 题 - тема\вопрос\упражнение\задание\заглавие
回答 - huí dá - отвечать\ответ
 回 - huí - возвращаться\поворачивать\разворачивать\отвечать\вращаться\кружить
 答 - dá - отвечать

zen/ me le - что случилось
chao- ji/ [] - супер-[]\сверх-[]
(?)就 - jiù - именно\как раз\уже\как
te\ bie/ - особенный
hua- - рисунок
hua\ hua\(r) - рисовать
shou- (ji/) - собирать\убирать\сдерживать\арестовывать
开心 - kāi xīn - счастливый
 我很开心 - я очень счастлив
dao [] - вернулся в\к []
qun\ - сонный

nian/ ji/ - класс\курс
ban- - группа\класс
ke/ - урок
yan/ jiu- sheng- - аспирант
bi\ ye\ - оканчивать(учебное заведение)
年龄 - nián líng - возраст
 年 - год\Новый Год
 龄 - возраст\годы\продолжительность\стаж
zai\ - опять\снова
 zai lai i zu - "снова вернемся 1 раз" - повторим еще раз
rang\ - разрешать\позволять\заставлять\освобождать путь\пропускать
nin - уважительное "ты"
zhao^ - искать
mei^ - каждый\всякий
真的吗？ - zhēn de ma - Правда?, В самом деле?
 zhen - истинный
 de - {преобразует прилагательное в существительное}
 ma - вопросительная частица
huan- ying/ - добро пожаловать
huang/ guan- - корона
bing\ du/ - вирус
[] wan/ - заканчивать [дело\занятие]
带 - dài - брать\носить с собой\приносить

里 - lǐ - родина\родные края
xing\ - воодушевление\интерес
该 - gāi - должен\следует
xi^ zao^ - купаться\принимать душ
si- ji- - водитель
qian/ - монета\деньги
dang\ - качаться\колыхаться\блуждать
liu\ - выгуливать(животное)\прогуливаться
刚 - gāng - только что\как раз
da\ jia- - все мы\каждый
da/ sao^ fang/ zi - чистить\прибирать дом
ji\ shu\ - техника
 ji - навык
tong/ xue/ - одноклассник
(摄氏)度 - (shè shì) dù - градус (Цельсия)
zou^ - ходить
 zou^ zou - гулять\прогуливаться
de/ yi^ - мочь\иметь возможность
da^ suan\ - планировать\намереваться
kou^ dai - карман\сумка\мешок
jue/ de - думать\считать
shuai- dao^ - свалиться\поскользнуться и упасть
shi\ - пробовать\примерять
e/ yu^ \ e/ wen/ - русский язык

房子 - fáng zi - дом\здание\квартира
 房 - fáng - дом\комната
租借 - zū jiè - арендовать
 租 - zū - арендовать\брать напрокат\сдавать в аренду
 借 - jiè - занимать\брать в долг\одалживать
房 - fáng - дом\комната
租房 - zū fáng - арендовать дом или квартиру 
房租 - fáng zū - арендная плата(за дом, квартиру и т.д.)\аренда

礼物 - lǐ wù - подарок\дар
过 - guò - проводить(время)\отмечать\праздновать
公司 - gōng sī - компания\фирма
 公 - gōng - (о животных)самец\ общественный\государственный\международный\открытый\гласный
 司 - sī - управлять\заведовать
工资 - gōng zī - зарплата
 工 - gōng - работа\труд\промышленность\умение
 资 - zī - деньги\товары\ресурсы\материалы\данные


迟到 - chí dào - опаздывать\быть поздно
 迟 - chí - медленный\поздний\запоздалый

课 - kè - урок\предмет\курс\учебное занятие
整整 - zhéng zhěng - полностью, целиком
幽默 - yōu mò - юмористический\юмор
性格 - xìng gé - характер\темперамент\натура
腼腆 - mián tiǎn - стеснительный\застенчивый\робкий
活泼 - huó pō - энергичный\оживленный

转账 - zhuǎn zhàng - переводить с одного банковского счета на другой\перевод
刷卡 - shuā kǎ - платить картой

现金 - xiàn jīn - наличные деньги\наличность
大海 - dà hǎi - море\океан
站 - zhàn - остановка\станция
马路 - mǎ lù - дорога\улица

小伙子 - xiáo huǒ zi - молодой человек
 伙 - huǒ - партнер\товарищ\компания\партнерство
走 - zǒu - ходить
经济 - jīng jì - экономика
系 - xì - отделение\факультет
作业 - zuò yè - домашняя работа\задание


学生 - xué sheng - студент\ученик

(音)乐 - yīn yuè - музыка
 音 - yīn - звук\слог\новость
 乐 - yuè - музыка

可以 - ké yǐ - можно\возможно
 可 - kě - можно\разрешается\довольно\так\очень
 以 - yǐ - чтобы\с целью\с помощью\посредством

像 - xiàng - напоминать\выглядеть как

广场 - guáng chǎng - площадь
 广 - широкий\обширный
 场 - место\поле\площадка

气 - qì - газ\воздух\дыхание\злиться

预报 - yù bào - прогноз
 预 - заранее\заблаговременно
 报 - газета\пресса\отчет\сводка\телеграмма

继续 - jì xù - продолжать
 继 - jì - наследовать\сменять\продолжать\следовать\затем\потом
 续 - xù - продолжать\добавлять\непрерывный\последовательный

之后 - zhī hòu - после\потом
 之 - направляться в, ехать в
 后 - назад

降 - jiàng - падать\опускаться\опускать\понижать\сдаться\победить

温 - wēn - температура\теплый\повторять\мягкий\нежный\ласковый

差 - chà - отличаться\недоставать

句子 - jù zi - фраза\предложение

电 - diàn - электричество
费 - fèi - плата\расходы\издержки\(+глагольные формы)
陪 - péi - сопровождать\проводить время с\помогать\ассистировать

先 - xiān - вначале\сперва\сейчас\первенство\старшее поколение\предок\передовой

网 - wǎng - сеть\сетка\Интернеты
 网课 - онлайн урок
 上网 - shàng wǎng - сидеть в Интернете

发型 - fà xíng - прическа
 发 - fà - волосы
 型 - xíng - шаблон\тип\модель\форма\образец

价 - jià - цена\ценность\(хим.)валентность

打折 - dǎ zhé - скидка
 打 - (делать руками)
 折 - zhé - ломать\умирать(молодым)\терпеть потери\делать скидку\гнуть\скидка\треснуть, сломаться\
 сворачивать\складной\книжка\буклет

部分 - bù fen - часть\доля\раздел
 部 - часть\раздел
 分 - минута\часть\доля\процент

一些 - yì xiē - некоторые\немногие\несколько
 些 - xiē - несколько\немного

把 - bǎ - (вводит дополнение со значением объекта, над которым совершается действие)
把 - bǎ - держать\управлять\наблюдать\связка\пучок\примерно\около\ручка


让 - ràng - (используется в пассивном залоге)\разрешать\позволять\отдавать\уступать\приглашать

打折 - dǎ zhé - продавать со скидкой\предлагать скидку

信 - xìn - письмо\сообщение\новость

老板 - láo bǎn - босс\шеф

别的 - bié de - другой\иной\еще

首先 - shǒu xiān - сперва\во-первых\прежде всего

一定 - yí dìng - обязательно\безусловно\непременно
 定 - dìng - установленный\фиксированный\предусмотренный

来不及 - lái bù jí - не успевать(что-то сделать)

及 - jí - союз и\достигать\сравниваться\не уступать\быть вовремя\успевать

热带 - rè dài - тропики\тропическая зона

地球仪 - dì qiú yí - глобус

桌游 - настольная игра
 游戏 - yóu xì - игра

价格 - jià gé - цена

爱好 - ài hào- интерес\увлечение\хобби
 爱 - ài - любовь\привязанность
 好 - hǎo - хороший\хорошо

等于 - děng yú - равняться\быть равным\быть равносильным

汉字 - hàn zì - китайский иероглиф

意思 - yì si - смысл\значение

公里 - gōng lǐ - километр(км)

千米 - qiān mǐ - километр
 米 - метр

墨镜 - mò jìng - солнцезащитные очки

次 - cì - раз(о повторении какого-либо действия)

重量 - zhòng liàng - вес
称重 - chēng zhòng - весить\взвешивать
消瘦 - xiāo shòu - похудеть\отощать

考试 - kǎo shì - участвовать в экзамене\экзамен

水草 - shuí cǎo - водные растения\водоросли

到了 - dào le - приехал\прибыл\(о событии) наступил\закончился(?)

一样 - yí yàng - такой же\одинаковый
 样 - yàng - внешний вид\форма\образец\тенденция

意思 - yì si - смысл\значение

就是 - jiù shì - (выражение согласия) - правильно\точно

事情 - shì qing - дело\событие

长 - zhǎng - расти\развиваться\длинный\долгий

代码 - dài mǎ - код
 代 - dài - заменять\замещать\занимать место\период\поколение\династия
 码 - инструмент
 写代码 - xiě dài mǎ - писать код

生活 - shēng huó - жизнь\жить
 活 - huó - жить\сохранять живым\выживать\живой\живущий

所有 - suó yǒu - все\всё\владение\собственность\владеть\обладать

习惯 - xí guàn - привыкать к\свыкаться с

袋子 - dài zi - мешок\пакет

性别 - xìng bié - пол

下水道 - xià shuǐ dào - канализация\сточная труба
 (маленькая водная река)

是吗？ - shì ma - Это так?\В самом деле?

升 - shēng - литр
 毫升 - - háo shēng - миллилитр
保温瓶 - bǎo wēn píng - термос
保温杯 - bǎo wēn bei - термокружка

无聊 - wú liáo - скучно

住 - zhù - жить в, проживать

小姐 - xiáo jiě - барышня\мисс\проститутка
姑娘 - gū niang - девушка

没 - méi - не\не иметь\не располагать\быть меньше чем

告诉 - gào su - сказать\дать знать
图片 - tú piàn - рисунок\картинка\иллюстрация\фотография

周 - zhōu - неделя\цикл\круг

注意 - zhù yì - обращать внимание\замечать\внимательно следить\остерегаться

土地 - tǔ dì - почва\земля\участок земли

久 - jiǔ - долгий\определенная продолжительность

加班 - jiā bān - работать сверхурочно
费 - fèi - плата\расходы\издержки
出门 - chū mén - выходить(из дома)
防 - fáng - предотвращать\защищать\защита(не используется самостоятельно)\дамба\плотина

收入 - shōu rù - доход\заработок\прибыль\поступления денежных средств
支出 - zhī chū - расходы

所有 - suó yǒu - все\всё\владение\собственность\владеть\обладать

转账 - zhuǎn zhàng - переводить с одного банковского счета на другой\перевод
取现金 - qǔ xiàn jīn - снимать наличные
现金 - xiàn jīn - наличные
银行 - yín háng - банк

娇 - jiāo - изнеженный\привередливый

地板 - dì bǎn - пол\настил
玻璃 - bō li - стекло

失眠 - shī mián - страдать бессонницей\терять сон

()清楚 - qīng chu - (говорить\видеть\слышать\..)чётко\ясно

堵塞 - dǔ sè - блокировать\загораживать\закупоривать\пробка\затор

起来 - qǐ lái - подниматься\вставать на ноги\вставать с постели
坐下 - zuò xia - садиться\присаживаться

任何 - rèn hé - любой\какой бы ни было

最 - zuì - самый
 最少 - минимум
 最多 - максимум

---------------------
对[]感兴趣 - duì [] gǎn xìng qù - интересоваться\испытывать интерес 
 感 - gǎn - чувствовать
 兴 - xìng - воодушевление\интерес
 趣 - qù - интерес\склонность\стремление\интересный

功夫 - gōng fu - Кунг-фу

非常 - fēi cháng - очень\чрезвычайно
当然 - dāng rán - конечно\без сомнения
特别 - tè bié - особенный\исключительный

厉害 - lì hai - (о словах, нраве)яростный\жестокий|(о характере)суровый\строгий|(о болезни)ужасная\критичная\серьезная|сильный\умный\крутой\лихой

一样 - yí yàng - такой же\одинаковый

帮(助) - bāng (zhù) - помогать\содействовать

词语 - cí yǔ - слова\выражения

唱歌 - chàng gē - петь песню\ходить в караоке-бар
本科 - běn kē - бакалавр\степень бакалавра
吉他 - jí ta - гитара

叫 - jiào - кричать\называть\звать\вызывать
客厅 - kè tīng - гостиная\зал
附近 - fù jìn - окрестности\округа
护照 - hù zhào - паспорт
地板 - dì bǎn - пол\настил
信息 - fā xìn xī - смс

开心 - kāi xīn - (открыть седрце)\счастливый\веселый\радостный
锁 - suǒ - замок\цепь\предмет в форме навесного замка\запирать

开 - kāi - открывать\включать\водить(автомобиль)
关 - guān - закрывать\затворять\выключать

电梯 - diàn tī - лифт\эскалатор
 梯 - tī - лестница\ступени

层 - céng - слой\ярус\этаж
楼 - lóu - этаж\высотное здание
 楼下 - lóu xià - внизу\нижний этаж здания

沙发 - shā fā - диван\софа
空调 - kōng tiáo - кондиционер

康复 - kāng fù - выздоравливать\поправляться

别急 - bié jí - не волнуйся\не торопись\не сердись
早日 - zǎo rì - поскорее\в самое ближайшее время

将来 - jiāng lái - будущее\в будущем
讨厌 - tǎo yàn - не любить\ненавидеть\испытывать отвращение

年假 - nián jià - ежегодный отпуск
假期 - jià qī - каникулы\отпуск

复习 - fù xí - повторять\пересматривать

厘米 - lí mǐ - сантиметр (см)

整夜 - zhěng yè - всю ночь\ночи напролёт

收 - shōu - собирать

发送 - fā sòng - передавать\отправлять\рассылать
河(流) - hé(liú) - река

票 - piào - билет\марка\чек\квитанция\бюллетень\голос\банкнота
教堂 - jiào táng - собор\храм

完(成) - wán(chéng) - выполнить\закончить
一样 - yí yàng - такой же\одинаковый

算 - suàn - считать\вычислять
 不算 - bú suàn - не в счет\не считаться
 算上 - suàn shàng - считая

来回 - lái huí - взад и вперед\туда и обратно

硬座 - yìng zuò - место в жестком вагоне поезда
硬卧 - yìng wò - плацкарт
软卧 - ruǎn wò - мягкое спальное место

刷牙 - shuā yá - чистить зубы

弹 - tán - играть на струнном или клавишном инструменте
钢琴 - gāng qín - фортепиано\пианино

爬上 - pá shàng - глаг взбираться на
爬山 - pá shān - подниматься на гору

邻居 - lín jū - сосед

自己 - zì jǐ - сам\себя\собственный

最 - zuì - самый
 最多 - zuì duō - максимум
 最少 - zuì shǎo - минимум

习惯 - xí guàn - привычка\обычай

一会 - yí huì - момент\мгновение\недолго\через мгновение

门口 - mén kǒu - дверь\ворота

以前 - yǐ qián - раньше\прежде

快乐 - kuài lè - счастливый\радостный

厚 - hòu - толстый\(о чувствах) глубокий\(о вкусе) сильный\богатый\толщина\глубина