打开 - dǎ kāi - открывать\включать
关闭 - guān bì - закрывать\запирать\выключать

怎么 - zěn me - как\каким образом\почему
中心 - zhōng xīn - центр
 心 - xīn - сердце\мысль\настроение\душа


安 - ān - безопасный\тихий\спокойный\стабильный

吵 - chǎo - ссориться\беспокоить\шумный
安静 - ān jìng - тихий\бесшумный\спокойный
 静 - jìng - тихий\неподвижный\успокаиваться\замолкать

危险 - wēi xiǎn - опасный\опасность
安全 - ān quán - безопасный\безопасность
 全 - quán - сохранять в целости\полный\целый

海 - hǎi - море\крупное озеро\множество\море
 每 - měi - каждый\всякий
船 - chuán - лодка\корабль

快 - kuài - скорый\быстрый
慢 - màn - медленный
 快慢 - kuài màn - скорость

更 - gèng - больше\еще более
便 - biàn - удобный\подходящий
更方便 - gèng fāng biàn - более удобный / удобно
 方 - fāng - направление\сторона

路线 - lù xiàn - путь\маршрут

转乘 - zhuǎn chéng - пересаживаться\пересадка
 转 - zhuàn - поворачиваться вокруг\вращаться\оборот
 乘 - chéng - путешествовать
中转 - zhōng zhuǎn - пересаживаться\делать трансфер
换乘 - huàn chéng - пересаживаться\делать пересадку
 换 - huàn - менять\обменять\конвертировать

迟到 - chí dào - опаздывать\быть поздно
 迟 - chí - медленный\поздний\запоздалый
 到 - dào - прибывать
准时 - zhǔn shí - пунктуальный\вовремя
 准 - zhǔn - образец\стандарт

总是 - zǒng shì - всегда
 总 - zǒng - суммировать\общий\суммарный

惩罚 - chéng fá - наказывать\наказание

不但...而且... - bú dàn ... ér qiě ... - не только..., но и...

速度 - sù dù - скорость

公里 - gōng lǐ - километр

高 - gāo - высокий\высота
宽 - kuān - широкий\ширина(короткая сторона)
长 - cháng - длинный\долгий\длинп(длинная сторона)

对 - duì - правильный\верный\для

帮助 - bāng zhù - помогать\содействовать

如果 - rú guǒ - если
那么 - nà me - так\таким образом\тогда

出差 - chū chāi - ехать в командировку

车 - chē - автомобиль\автобус\транспортное средство

选(择) - xuǎn (zé) - выбирать\выбор

旅游 - lǚ yóu - путешествовать\совершать поездку

价格 - jià gé - цена

酒店 - jiǔ diàn - гостиница\отель\винный магазин\бар

地铁 - dì tiě - метро

正常 - zhèng cháng - нормальный\обычный

(大)自然 - (dà) zì rán - природа

或者 - huò zhě - или, либо
战争 - zhàn zhēng - война

害怕 - hài pà - бояться\пугаться\страшиться

担心 - dān xīn - волноваться
 担 - dān - брать на себя\ноша\бремя

堵车 - dǔ chē - образовалась пробка\возник затор
 堵 - dǔ - блокировать\преграждать путь

偶尔 - óu ěr - от случая к случаю\время от времени\иногда

纪念品 - jì niàn pǐn - памятный подарок\сувенир
 纪 - jì - записывать (одинак. с 记)\дисциплина\эра\эпоха
 念 - niàn - учиться\скучать\обдумывать\идея\мысль
  今 - jīn - настоящее время\ныне\современный\нынешний
 品 - pǐn - предмет\продукт\сорт\класс

让 - ràng - (используется в пассивном залоге)\разрешать\позволять\пропускать

严重 - yán zhòng - серьезный\тяжелый(для плохих качеств\ситуаций)

立马 - lì mǎ - сразу\немедленно\быстро\мгновенно
 立 - lì - стоять\возвышаться\устанавливать
突然 - tū rán - неожиданный\неожиданно\внезапно

袋 - dài - мешок\пакет
支出 - zhī chū - платить\тратить\расход
设备 - shè bèi - оборудование\приборы
付款 - fù kuǎn - производить платеж\оплачивать
同事 - tóng shì - сослуживец\коллега

复活节 - fù huó jié - Пасха
劳动节 - láo dòng jié - День труда

展(览)会 - zhán (lǎn) huì - выставка, показ

膏 - gāo - паста
刷 - shuā - щетка
亮 - liàng - яркий\светлый
岁 - suì - год\урожай в году\время
害羞 - hài xiū - стесняться\смущаться
种 - zhǒng - вид\класс\тип\сорт|сажать\выращивать\засевать\возделывать

已经 - yǐ jīng - уже

桶 - tǒng - бочка\ведро
垃圾 - lā jī - мусор\отбросы\дрянной
梦 - mèng - сон\видеть сны\мечтать\грезить

多么 - duō me - как\в какой степени
怎么 - zěn me - как\каким образом\почему

醒 - xǐng - проснуться\пробудиться\очнуться\бодрствовать\осознавать
脏 - zāng - грязный\нечистый\испачканный

陪伴 - péi bàn - сопровождать
到处 - dào chù - везде\повсюду

排队 - pái duì - стоять в очереди
 排 - pái - линия\плот\взвод\ряд
几 - jǐ - несколько\немного\сколько?

沙子 - shā zi - песок

语言 - yǔ yán - язык
厘米 - lí mǐ - сантиметр (см)

厉害 - lì hai - сильный\умный\крутой\лихой

变 - biàn - становиться\изменяться\изменять
特别 - tè bié - особенный\исключительный
感觉 - gǎn jué - чувствовать\ощущать\отдавать себе отчет\полагать

咳嗽 - ké sou - кашлять\кашель
打喷嚏 - dǎ pēn tì - чихать
(发)痒 - (fā) yǎng - чесаться\зудеть

坚果 - jiān guǒ - орех

蜂蜜 - fēng mì - мед
蜜蜂 - mì fēng - пчела

二维码 - èr wéi mǎ - двухмерный штрих-код\QR код

只 - zhī - один\единственный
只 - zhǐ - только\просто\всего лишь

其他 - qí tā - другой, другие (по отношению к людям или предметам) 
 其他人 - qí tā rén - другие люди\остальные

客人 - kè ren - гость

服务员 - fú wù yuán - обслуживающий персонал\официант\официантка

汤 - tāng - суп\кипяток\горячие источники
镜子 - jìng zi - зеркало\(неформ.)очки
毛巾 - máo jīn - полотенце
菜单 - cài dān - меню
老了 - lǎo le - состариться
计划 - jì huà - планировать\план
重新 - chóng xīn - еще раз\снова\с самого начала
骗 - piàn - обманывать\выманивать, получать обманом

从(来) 没\不 - cóng (lái) méi\bù - никогда(не делал чего-то)

之间 - zhī jiān - между

双 - shuāng - [счетное слово для обуви и других парных вещей]1

尝尝 - cháng chang - попробовать
恢复 - huī fù - восстанавливать(ся)\оправляться\выздоравливать
现金 - xiàn jīn - наличные деньги\наличность
转账 - zhuǎn zhàng - переводить с одного банковского счета на другой\перевод

月初 - yuè chū - начало месяца
月中 - yuè zhōng - середина месяца
月末 - yuè mò - конец месяца

商品 - shāng pǐn - товар\продукт

生产 - shēng chǎn - производить
教 - jiāo - учить\обучать\преподавать
摄像头 - shè xiàng tóu - камера\веб-камера
努力 - nǔ lì - старательный\усердный\прилагать усилия
准备 - zhǔn bèi - готовить(ся)\подготовить(ся)\собираться\планировать
聊天 - liáo tiān - болтать\беседовать
相信 - xiāng xìn - верить\доверять\иметь уверенность в
线 - xiàn - нить\струна\транспортный путь\трасса\(геом.) линия\провод
练习 - liàn xí - практиковаться\практика\упражнение
骗子 - piàn zi - мошенник\обманщик\жулик\плут
作业 - zuò yè - домашняя работа\задание
一样 - yí yàng - такой же\одинаковый