jia- - семья\дом
jie/ hun- - жениться\выходить за муж
lin/ ju- - сосед
xing\ bie/ - пол(м\ж)
hai/(r) zi - ребенок\дети
nv^ (zi)(ren) - женщина
nan/ (zi)(ren) - мужчина
 nan hai - мальчик
 nv hai - девочка
peng/ you - друг
nv^ peng/ you - девушка(подруга)
nan/ peng/ you - парень(друг)
jie^ jie - старшая сестра
mei\ mei - младшая сестра
ge- ge - старший брат
di\ di - младший брат
ma- ma - мать
ba\ ba - отец

儿子 - ér zi - сын
 儿 - ér - сын\ребенок\молодой человек\молодежь\мужской
女儿 - nǚ ér - дочь

shu- shu - дядя
a- yi - тетя


女士 - nǚ shì - госпожа\леди\мисс\мадам
 士 - shì - холостяк\ученый\достойный похвалы человек\воин
先生 - xiān sheng - господин\сэр\муж\учитель
 先 - xiān - вначале\сперва\сейчас\первенство

妻子 - 妻子 - qī zi - жена
丈夫 - zhàng fu - муж\супруг

老婆 - lǎo po - (неформ.)жена
 老 - lǎo - старый\престарелый\стародавний\прежний\переспелый
 婆 - pó - старуха\пожилая женщина\свекровь
老公 - lǎo gōng - (неформ.)муж
 公 - gōng - (о животных)самец

nai^ nai - бабушка со стороны отца
wai\ po/ - бабушка со стороны матери
姥姥 - бабушка со стороны матери
 姥 - lǎo - бабушка со стороны матери\мать матери
ye/ ye - дедушка со стороны отца
lao^ ye - дедушка со стороны матери

客 - kè - гость\посетитель

夫妻 - fū qī - муж и жена\супруги

情侣 - qíng lǚ - влюбленные\возлюбленные