很高兴认识你 - hěn gāo xìng rèn shi nǐ - Очень приятно с тобой познакомиться
 很 - очень
 高 - высокий
 兴 - воодушевление\интерес
 认 - узнавать\распознавать
 识 - знать\узнавать
kan\ qi^ lai/ - выглядеть
hen^ shen/ qi/ - чудесно
zai\ jian\ - до свидания
好久不见 - háo jiǔ bú jiàn - давно не виделись
 好 - хорошо
 久 - долго
 不 - не
 见 - встречаться
wan^ an- - спокойной ночи
zai\ lai/ yi/ ci\ - еще раз\повторно\снова
sheng- bing\ le - заболеть
nǐi^ jiao\ shen/ me ming/ zi - как тебя зовут
xing\ ming/ - полное фамилия и имя
xie\ xie - спасибо
bu/ ke\ qi - не стоит благодарности\не за что
对不起 - duì bu qǐ - простите\извините
mei/ guan- xi - не бери в голову
bu\ hao^ yi\ si - извините за неудобство\чувствовать себя неловко
hao^ de - хорошо\ладно
yi\ ban- ban- - так себе\ни хорошо, ни плохо
zhi^ hui^ jiao- tong- - регулировать (авто) траффик
gei/ wo ... - принесите\подайте мне ...
ni^ shi\ na^ guo/ ren/ ? - ты из какой страны
ni^ lai/ zi\ na^ ge\ guo jia- - ты из какой страны
ni^
 lai/ zi\ - происходить из\приезжать из
 na li - откуда
ni^ qu\ nar - куда ты собираешься?
wo^ jue/ de/ ... - чувствую\думаю\кажется, что ...
xia\ ke\ - заканчивать занятия
 xia\ - следующий
 ke\ - учебное занятие
shang\ ke\ - приходить на урок\посещать занятия\находиться на уроке
[cuo] de hao ma - хорошо делаешь?
 cuo может быть заменено на другой глагол действия
 ta de hao ma - играешь(рукой) хорошо?
wo^ you/ dian^ [] - я немного []
 wo^ you/ dian^ lei le - я немного устал
xian- [], zai\ [], zui\ hou\ [] - сначала [], потом [], в конце []
小时候 - xiǎo shí hou - сущ детство, детский возраст
多少钱[] - duō shao qián [] - сколько стоит []
(da\) jia- hao^ - всем привет
我到家 - wǒ dào jiā - я дома!
你呢 - nǐ ne - а ты?\А что на счет тебя?
有时候 - yǒu shí hou - иногда\временами
 有时候[这个], 有时候[那个] - иногда [это], иногда [то].
好久不见 - háo jiǔ bú jiàn - давно не виделись
她多大了 - tā duō dà le - фраза Сколько ей\ему лет?
差不多 - chà bu duō - похожий\почти\практически
先[]，然后[] - xiān,[] rán hòu [] - сначала[], а потом[]
天气预报 - tiān qì yù bào - прогноз погоды
我看到了。 - wǒ kàn dào le - Я увидел.
真的吗？ - zhēn de ma - Правда?, В самом деле?
我看不到 - wǒ kàn bú dào - Я не вижу
 到 - dào - прибывать\добираться\(используется после глагола и указывает на результат действия)
明白了吗？ - míng bai le ma ? - Понял?\Понятно?
 明 - míng - яркий\светлый\зрение\ясно видимый\понимать\явный\отчетливый
 白 - bái - белый\светлый\бесплатно\не прилагая усилий\ясный\чистый
说实话 - shuō shí huà - честно говоря\по правде сказать
 说 - shuō - говорить\сказать\исполнять\убеждать\учение\теория\доктрина
 实 - shí - факт\действительность\плод\семя\крепкий\цельный\конкретный\искренний
 话 - huà - слова\речь\говорить\рассказывать

在线 - zài xiàn - быть в режиме онлайн
 在 - zài - в течение\в процессе\в\на\существовать\занимать должность
 线 - xiàn - нить\струна\хлопок\шерсть\трасса\линия\граница\край\грань

每天 - měi tiān - каждый день

水电费 - shuǐ diàn fèi - коммунальные платежи за воду и электричество

我想吐 - wó xiǎng tù - Меня тошнит\Меня сейчас вырвет
 吐 - tù - плевать\рвать\тошнить\неохотно отдавать\плевать\выплевывать\говорить\высовывать

不好意思 - bù hǎo yì si - чувствовать себя неловко\извиняться за неудобства
 意思 - yì si - смысл\значение\мнение\желание\благодарность\знак привязанности\интерес
  意 - yì - смысл\значение\желание\намерение\ожидать
  思 - sī - думать\размышлять\скучать\тосковать\желать\чувства\размышления

下次 - xià cì - следующий раз
 次 - cì - раз(о повторении какого-либо действия)\порядок\последовательность

又是 - опять же

我错了 - wǒ cuò le - Я был неправ\Я сделал ошибку
 错 - cuò - ошибочный\плохой\сложный\запутанный

欢迎(光临)! - huān yíng (guāng lín) - Добро пожаловать!\(досл - радостно приветствие, светлого прибытия)
 欢 - huān - довольный\радостный\(диал.)оживленный\возлюбленный
 迎 - yíng - приветствовать\встречать\стоять лицом к
 光 - guāng - свет
 临 - lín - приходить\прибывать

我的工作需要中文 - моя работа требует знания китайского языка

驾驶证 - jià shǐ zhèng - водительские права\водительское удостоверение

一下(儿) - yí xià(r) - немного\один раз\разок\(после глагола)один раз

少来了 - shǎo lái le - (разг.)давай

你多大了 - nǐ duō dà le - (вопрос к младшему по возрасту или ровеснику) Сколько тебе лет?

少于 - shǎo yú - быть меньше, чем ... 
 少 - shǎo - недоставать\юный
 于 - yú - (указывает на сравнение)чем

不合适 - bù hé shì - не подходить\не годиться\неуместный

不到 - bú dào - не достигать\недостаточный\меньше чем\меньше
 到 - доходить, достигать

太可怕了 - tài kě pà le - ужас, ужас!

不可能 - невозможно
 能 - néng - мочь\быть в состоянии сделать\способность\умение\энергия

做过了 - (уже) сделал это

看不出来 - kàn bu chū lái - фраза нельзя понять (из наблюдений)\никак не разглядеть 
 (взгляд не выходит)

小意思 - xiǎo yì si - мелочь\пустяк(вежл. о своем подарке)
没意思 - méi yì si - скучный\неинтересный\бессмысленный
 意思 - yì si - смысл\значение

拖地 - tuō dì - мыть пол
 拖 - tuō - тянуть\тащить\волочить\свисать\медлить\обременять
 地 - dì - земля\почва\пол\низ\фон

错梦 - cuò mèng - кошмар
 (неправильный сон\грезы)

[]起来[] - [] qi lai [] - (применяется с глаголами звучать\выглядеть\... для обозначения свойств. Например, выглядеть странно, звучать громко)

请慢用 - qǐng màn yòng - приятного аппетита!

所有时间 - shí jiān suó yǒu - вся жизнь
坐下 - zuò xia - садиться\присаживаться
电话响了 - diàn huà xiǎng le - звонит телефон

对[]感兴趣 - duì [] gǎn xìng qù - испытывать интерес к\интересоваться

赚钱 - zhuàn qián - зарабатывать деньги\получать прибыль
花钱 - huā qián - тратить деньги

从[]到[] - cóng [] dào [] - из [] в []
从[]去[] - cóng [] qù [] - из [] в []

洗碗 - xí wǎn - мыть посуду

先[]再[] - xiān[]zài[] - сначала[], а потом[]

够了 - gòu le - Хватит!\Достаточно!\Довольно!

打雪仗 - dá xuě zhàng - играть в снежки

雪橇 - xuě qiāo - сани\салазки
春联 - chūn lián - парные надписи с новогодними пожеланиями
财神 - cái shén - бог богатства
 财 - cái - деньги\богатство
拜年 - bài nián - желать счастливого Нового года\наносить визит в Новый год или вскоре после его наступления, обычно с подарком
滑倒 - huá dǎo - поскользнуться и упасть
几月几号 - jǐ yuè jǐ hào - какой месяц и какое число
只是 - zhǐ shì - всего лишь\просто\однако\но
太快了 - tài kuài le - Слишком быстро

老人 - lǎo rén - пожилой человек\старик
雪橇 - xuě qiāo - сани\салазки

...着呢 - [сейчас]
弹吉他 - tán jí tā - играть на гитаре

睡症了 - shuì zhèng le - проспать

几天 - jǐ tiān - несколько дней\сколько дней(в вопросе)
家务 - jiā wù - домашние дела\работа по дому
就在那边 - jiù zài nà biān - вон там

不但...而且... - bú dàn ... ér qiě ... - не только ... но и ...

前后 - qián hòu - примерно\около\от начала до конца\спереди и сзади

\\\\\\\\\\\\\\\\\\\\\\\\\\
举重 - jǔ zhòng - поднимать тяжести
偶尔 - óu ěr - от случая к случаю\время от времени\иногда
只能 - zhǐ néng - мочь только
欢迎光临 - huān yíng guāng lín - Добро пожаловать
 欢迎 - huān yíng - приветствовать
 光临 - guāng lín - (почтительное) присутствие (гостя)\присутствовать

\\\\\\\\\\\\\\\\\\\\\\\\\\
接机 - jiē jī - встретить в аэропорту
[]快乐 - []kuài lè - C [праздником]!
