短 - duǎn - короткий
长 - cháng - длинный\долгий

矮 - ǎi - невысокий\низкий
高 - gāo - высокий

大 - dà - большой
小 - xiǎo - маленький\недолго\почти

早 - zǎo - ранний\раньше\уже\давно
晚 - wǎn - поздний\запоздалый

轻 - qīng - легкий\неважный\слабый\мягкий
重 - zhòng - тяжелый\сильный\серьезный

远 - yuǎn - далекий
近 - jìn - близкий\приближаться

漂亮 - красивый\прекрасный\замечательный\блестящий
 漂 - piào - красивый\замечательный
 亮 - liàng - яркий\светлый\звучный\свет\светить\сверкать
帅 - shuài - красивый (о мужчине)
 好看 - hǎo kàn - хорошо смотрящийся\красивый(предмет)

多变 - duō biàn - меняющийся\непостоянный\переменный(матем.)
 变 - biàn - становиться\изменяться\изменять

新 - xīn - новый\неиспользованный\новобрачный\только что\недавно
旧 - jiù - старый\подержанный\бывший

最 - zuì - самый
困 - kùn - сонный\усталый\трудный
差 - chà - отличаться\недоставать\отсутствовать\неправильный\плохой\низший
好 - hǎo - хороший\добрый\дружелюбный\здоровый
可怕 - kě pà - страшный\ужасный
 可 - kě - можно\разрешается\довольно\так\очень
 怕 - pà - бояться\опасаться

快 - kuài - скорый\проворный\отточенный\веселый\радостный\скоро\вскоре
久 - jiǔ - долгий\определенная продолжительность

瘦 - shòu - худой\(об одежде) узкий, тесный
胖 - pàng - (о человеке) толстый, пухлый

坏 - huài - плохой\сломанный\испорченный

悄 - qiāo - тихий\тихо\молчаливый

最后 - zuì hòu - последний\(букв. - самый задний)
第一个 - dì yī gè - первый
 第 - dì - (префикс перед порядковым числительным)

舒服 - shū fu - легкий\свободный\удобный\чувствовать себя хорошо\комфортно

方便 - fāng biàn - удобный\удобно
 方 - fāng - направление\сторона
 便 - biàn - удобный\подходящий

敏感 - mín gǎn - чувствительный\восприимчивый

价 - jià - цена\ценность\(хим)валентность

一样 - yí yàng - такой же\одинаковый

最 - zuì - самый

奇怪 - qí guài - странный\причудливый

辛苦 - xīn kǔ - (о труде)тяжелый\упорный\тяжело трудиться\работать в поте лица

可爱 - kě ài - милый\очаровательный
 (можно любить)

悄悄 - qiāo qiāo - тихий\тихо\потихоньку