食物 - shí wù - продукты питания\пища

挑食 - tiāo shí - быть привередливым в еде

煎 - jiān - жарить на масле
炸 - zhá - жарить в масле
炒 - chǎo - жарить(в масле на сильном огне)
煮 - zhǔ - варить\кипятить

菜 - cài - блюдо\овощи\кухня(традиции приготовления)
 炒菜 - chǎo cài - жареное блюдо
 蔬菜 - shū cài - овощи
  蔬 - shū -  овощ

水草 - shuí cǎo - водные растения\водоросли

味道 - wèi dào - вкус\привкус\запах
 味 - wèi - вкус\привкус\запах
 道 - dào - путь\дорога\тракт\говорить\способ\метод
好吃 - hǎo chī - вкусный
无味 - wú wèi - безвкусный
辣 - là - острый\пряный\суровый\жестокий
甜 - tián - сладкий\крепкий(сон)\веселый\приятный
咸 - xián - соленый
酸 - suān - кислый\печальный\огорченный\кислота(хим.)
饱 - bǎo - полный\сытый\удовлетворять
 吃饱 - наесться\насытиться

饿 - è - голодать\испытывать голод\голодный
外卖 - wài mài - еда на вынос\еда с доставкой на дом
 外 - wài - внешняя часть\чужой\не свой\неофициальный\отдаленно связанный\со стороны матери(о родственниках)
 卖 - mài - продавать\предавать
 我吃外卖 - я ем еду с доставкой
火锅 - huǒ guō - хотпот

烤肉 - kǎo ròu - жарить мясо\жареное мясо
 烤 - kǎo - жарить\поджаривать\печь\греться у огня

水 - shuǐ - вода
 开水 - кипяченая вода
  开 - kāi - открывать\включать\водить(автомобиль)
 热水 - горячая вода
  热 - rè - горячий\жаркий\популярный
 温水 - теплая вода
  温 - wēn - теплый\греть\повторять\температура\мягкий\нежный\ласковый
 凉水 - холодная вода
  凉 - liáng - прохладный\холодный\подавленный\грустный\заброшенный\остужать
 冰水 - ледяная вода
  冰 - bīng - лед\предмет, напоминающий лед\кристалл

餐 - cān - еда\пища\есть\кушать
饭 - fàn - еда\пища\
 早饭 - завтрак
 午饭 - обед
 晚饭 - ужин

ОВОЩИ
生菜 - shēng cài - салат-латук
西兰花 - xī lán huā - брокколи
qie/ zi - баклажан
lv dou - стрючковая фасоль
xi- hong/ shi\ - помидор
yu\ mi^ - кукуруза
土豆 - tǔ dòu - картофель\[земельная фасоль]
(胡)椒 - (hú) jiāo - перец
mo/ gu - гриб
nan/ gua- - тыква
huang/ gua- - огурец
yang/ cong- - лук
胡萝卜 - hú luó bo - морковь\морковка

ФРУКТЫ
jing- tao/ - вишня
li - груша
xiang- jiao- - банан
ning meng - лимон
xi- gua- - арбуз
pu/ tao - виноград
cao^ mei/ - клубника
cheng/ zi - апельсин
ju/ zi - мандарин
桃子 - táo zi - персик\нектарин
荔枝 - lì zhī - личжи\фрукт любви

НАПИТКИ
可可 - ké kě - какао
饮料 - yǐn liào - питье\(безалкогольный)напиток
果汁 - guǒ zhī - сок(фруктовый)
 []汁 - сок из [фрукта\овоща\ягоды]
可乐 - kě lè - кола
suan- nai^ - йогурт
jiu^ - вино\алкоголь
hong/ jiu^ - красное вино
bai/ jiu^ - китайская водка
pi/ jiu^ - пиво
niu/ nai^ - коровье молоко

ПРОЧЕЕ
瓜子 - guā zǐ - семечки
口香糖 - kǒu xiāng táng - жевательная резинка\жвачка
 香 - xiāng - ароматный\благоухающий\вкусный\специи\духи\благовония
糖 - táng - сахар\конфеты\сладости\углевод(хим.)\карбогидрат(хим.)
奶酪 - nǎi lào - сыр
奶渣 - nǎi zhā - творог
 奶 - nǎi - молоко\грудь\кормить грудью
 酪 - lào - (несамостоятельный иеролгиф) сыр\китайский крем\густой фруктовый крем
 渣 - zhā - осадок\остаток\шлак
dan\ gao\ - торт\пирог
tian/ quan- - пончик
面包 - miàn bāo - хлеб\булка
 包 - bāo - оборачивать
巧克力 - qiǎo kè lì - шоколад
jian bing - блинчики
mai\ pian\ - овсяные хлопья
mian\ tiao/ - лапша
zhou- - жидкая каша
mi^ zhou- - каша
mi^ fan\ - рис
yan\ mai\ - овес
饺子 - jiǎo 子 - китайские пельмени
水果 - shuí guǒ - фрукт
 果 - guǒ - фрукт\исход\результат
dan\ - яйца
sha- la- - салат
香肠 - xiāng cháng - колбаса\сосиска

冰激凌 - bīng jī líng - мороженное
 冰 - лед
 激 - jī - резкий\бурный\радикальный\взволнованный\побуждать\остужать(пищу), помещая в холодную воду
 凌 - líng - приближаться\подниматься\возноситься\оскорблять\угнетать\льдинка\лед

汉堡(堡) - hàn bǎo (bǎo) - гамбургер\бургер

煎蛋 - jiān dàn - яичница\омлет
饼干 - bǐng gān - печенье\бисквит

核桃 - hé tao - грецкий орех
坚果 - jiān guǒ - орех