动物 - dòng wù - животное
 动 - dòng - двигаться\действовать
 物 - wù - вещь\предмет\объект\вещество\материя\содержание

宠物 - chǒng wù - любимец\домашнее животное
 宠 - chǒng - баловать\питать благосклонность
 物 - wù - вещь\предмет\внешний мир\вещество\субстанция\содержание

只 - zhī - счетное слово для птиц и некоторых животных
老 - láo - старый\оригинальный\обыкновенный(биол.)

角 - jiǎo - рог\усик(у насекомых)\угол\(геогр.)мыс

鸟 - niǎo - птица
刺猬 - cì wei - еж
 刺 - cì - втыкать\прокалывать\шип\колючка
猫 - māo - кот
熊 - xióng - медведь
熊猫 - xióng māo - панда
猪 - zhū - свинья
牛 - niú - корова
羊 - yáng - овца\баран
鱼 - yú - рыба
 三文鱼 - sān wén yú - лосось
狗 - gǒu - собака
鼠 - shǔ - мышь\крыса
 老鼠 - láo shǔ - мышь\крыса
 松鼠 - sōng shǔ - белка
  松 - sōng - сосна
虎 - hǔ - тигр
 老虎 - láo hǔ - тигр(обыкновенный)
蛇 - shé - змея
狼 - láng - волк
兔子 - tù zi - кролик
 兔 - tù - заяц\кролик
蜜蜂 - mì fēng - пчела
 蜜 - mì - мёд
 蜂 - fēng - оса\пчела\роем\толпой
鸭子 - yā zi - утка
 鸭 - yā - утка
鸡 - jī - петух\курица
 母鸡 - mǔ jī - курица
  母 - mǔ - (о животных и птицах)самка
 公鸡 - gōng jī - петух
  公 - gōng - (о животных)самец
 火鸡 - huǒ jī - индейка
  火 - huǒ - огонь
马 - mǎ - лошадь\конь
蚂蚁 - má yǐ - муравей
 蚂 - mǎ - насекомое(не используется в одиночку)
 蚁 - yǐ - муравей
猴子 - hóu zi - обезьяна
大象 - dà xiàng - слон
 象 - xiàng - слон\подражать\внешний вид\образ


鹿 - lù - олень
长颈鹿 - cháng jǐng lù - жираф
 长 - cháng - длинный\долгий
 颈 - jǐng - шея\шейка\горлышко
驯鹿 - xùn lù - северный олень

鲱鱼 - fēi yú - сельдь

虫子 - chóng zi - насекомое\червь\жук

企鹅 - qǐ é - пингвин

梅花鹿 - méi huā lù - пятнистый олень

蝴蝶 - hú dié - бабочка