ГЕОГРАФИЯ
he/ - река
 fu/ er^ jia- he/ - река Волга
shan- - гора
cheng/ shi\ - город
hong/ cun- - деревня
海边 - hǎi biān - берег моря\морское побережье
 海 - hǎi - море\крупное озеро
别墅 - bié shù - загородный дом\вилла\дача
郊区 - jiāo qū - пригород\предместье\окраина
公园 - gōng yuán - парк
 动物园 - зоопарк

ЗДАНИЯ
宿舍 - sù shè - общежитие
 宿 - жить
 舍 - дом\общежитие
zai\ jia- - оставаться дома\дома\родной дом
 jia- - семья\дом
 zai\ - в течении\в процессе\(continous)
bo/ wu\ guan^ - музей
医院 - yī yuàn - больница\госпиталь
 医 - yī - врач\медицина\лечить\вылечивать
 院 - yuàn - двор\публичное место\институт\академия
学校 - xué xiào - школа\образовательное учреждение 
 学 - xué - учить\исследовать\подражать\имитировать\наука\школа\знание
 小学 - xiǎo xué -начальная школа
 初中 - chū zhōng - средняя школа
  初 - chū - начальный\первичный
 高中 - gāo zhōng - старшая школа
 大学 - dà xué - университет

银行 - yín háng - банк
旅馆 - lǘ guǎn - отель\гостиница
酒店 - jiǔ diàn - гостиница\отель\винный магазин\бар

餐厅 - cān tīng - ресторан\столовая\обеденный зал

商店 - shāng diàn - магазин
药店 - yào diàn - аптека

商场 - shāng chǎng - рынок\торговый центр
shi\ chang^ - рынок
chao- shi\ - супермаркет

图书馆 - tú shū guǎn - библиотека
 馆 - guǎn - место для культурных или спортивных мероприятий\место проживания туристов\особняк\правительственное учреждение\посольство\консульство