穿 - chuān - надевать\носить одежду
戴 - dài -надевать\носить аксессуары(очки\шляпы\перчатки\галстук\..)

帽子 - mào zi - шляпа\шапка\кепка\головной убор
衣服 - yī fu - одежда
 衣 - yī - одежда\платье\покров\оболочка\плацента
 服 - fú - платье\одежда\надевать\носить

鞋子 - xié zi - ботинок\туфля\обувь
 运动鞋 - yùn dòng xié - кроссовки\спортивная обувь
  运动 - спорт
 高跟鞋 - gāo gēn xié - туфли на высоком каблуке
  (высокий каблук обувь)
сущ туфли на высоком каблуке 
脱鞋 - tuō xié - снимать обувь
 脱 - tuō - снимать\осыпаться\выпадать\пропускать(слова)\убирать\избавляться от
拖鞋 - tuō xié - тапочки
 拖 - tuō - тянуть\тащить\волочить\свисать\тянуть\медлить\обременять

雨伞 - yú sǎn - зонт
 雨 - yǔ - дождь
 伞 - sǎn - зонт\предмет в форме зонтика
袖子 - xiù zi - рукав(одежды)
袜子 - wà zi - носки\чулки
裙子 - qún zi - юбка\платье
 连衣裙 - lián yī qún - (женское)платье
裇 - xū - рубашка\футболка
衬衫 - chèn shān - рубашка\блузка
 衬 - chèn - подкладывать\подстилать\выделять\нижнее белье\нательное белье\подкладка
 衫 - shān - одежда без подкладки\общий термин для одежды
裤 - kù - брюки\штаны
 裤带 - kù dài - ремень
  带 - dài - ремень\ремешок
 牛仔裤 - niú zǎi kù - джинсы
 休闲裤 - xiū xián kù - свободные домашние штаны
  休闲 - xiū xián - быть свободным\отдыхать