东西 - dōng xi - вещь\предмет\(букв. - восток-запад)

冰箱 - bīng xiāng - холодильник
 冰 - лед
 箱 - ящик\чемодан\предмет в форме ящика

门 - mén - дверь\ворота\клапан\заслонка
灯 - dēng - лампа\свет\горелка

电 - diàn - электричество\молния\телеграмма
 电脑 - diàn nǎo - компьютер
  脑 - nǎo - мозг\мозги
   笔记本电脑 - bǐ jì běn diàn nǎo - ноутбук
 电视 - diàn shì - телевизор
  视 - shì - смотреть на\наблюдать\следить
 电影 - diàn yǐng - фильм\кино
  影 - yǐng - тень\след\фотография\кино\фильм
椅子 - yǐ zi - стул\кресло
凳子 - dèng zi - табурет\скамья
桌 - zhuō- zi - стол\парта
窗(户) - chuāng (hu) - окно
 户 - hù - дверь\семья\хозяйство\двор
机 - jī - двигатель\машина\самолет
洗衣机 - xǐ yī jī - стиральная машина
 (мыть одежда машина)


床 - chuáng - кровать
 铺 - pū - расстилать\раскладывать\мостить\постель\койка\лавка\магазин
枕头 - zhěn tou - подушка
 枕 - zhěn - класть голову на\подкладывать\подушка
被子 - bèi zi - одеяло 

柜子 - guì zi - шкаф
 床头柜 - chuáng tóu guì - прикроватная тумбочка
 衣柜 - yī guì - шкаф\гардероб

镜子 - jìng zi - зеркало
沙发 - shā fā - диван\софа
电话 - diàn huà - (стационарный)телефон\(телефонный)звонок
邮件 - yóu jiàn - почта\почтовое отправление
(雨)伞 - (yú) sǎn - зонт
铅笔 - qiān bǐ - карандаш
盒子 - hé zi - коробка\ящик
本子 - běn zi - тетрадь\блокнот
眼镜 - yǎn jìng - очки(для зрения)

锅 - guō - сковорода\кастрюля\котел
 炒锅 - chǎo guō - вок\сковорода для жарки
勺子 - sháo zi - ложка
杯子 - bēi zi - стакан\кружка
碗 - wǎn - чаша\пиала\миска
刀子 - dāo zi - нож
叉子 - chā zi - вилка
盘子 - pán zi - тарелка\блюдо
瓶子 - píng zi - бутылка
盖子 - gài zi - крышка\панцирь
 瓶盖 - píng gài - крышка от бутылки
筷子 - kuài zi - сущ палочки для еды

洗手盆 - xí shǒu pén - раковина
 盆 - pén - таз\чан\горшок



书 - shū - книга\документ\письмо\писать
报纸 - bào zhǐ - газета

空调 - kōng tiáo - кондиционер
 空 - kōng - пустой\полый\бессодержательный\впустую\опустошат\очищать\незаполненный\незанятый\небо\воздух
 调 - diào - переводить\перемещать\расследовать\мелодия\мотив\акцент\мнение\тон\гармоничный\смешивать\регулировать\настраивать\примирять\провоцировать\подстрекать

风扇 - fēng shàn - вентилятор
 风 - fēng - ветер\продувать\сушить на ветру\новости\информация\обычай\тенденция\сцена\пейзаж\необоснованный\ветер
 扇 - shàn - веер\створка\доска\обмахивать\обдувать

shu\ - дерево
hua - цветок
qiu- qian- - качели
shu- bao- - школьный рюкзак
bei- bao- - рюкзак

手机 - shǒu jī - мобильный телефон
 机 - jī -двигатель\машина\самолет\удобный случай\тайна\движущая сила\толчок\
 стимул

纸 - zhǐ - бумага\(счетное слово для писем, документов)
篇 - piān - сочинение\произведение\лист бумаги\(счетное слово для сочинений и статей) 
瓶 - píng - бутылка\ваза

手表 - shóu biǎo - наручные часы
 表 - biǎo - часы\счетчик

水龙头 - shuǐ lóng tóu - (водопроводный)кран\вентиль
 水 - вода
 龙 - lóng - дракон
 头 - голова

麦克风 - mài kè fēng - микрофон

页 - yè - страница\лист