健身房 - jiàn shēn fáng - спортивный зал\фитнес-центр
 健 - jiàn - здоровый\укреплять\быть мастером в
 身 - shēn - тело\костюм\комплект\главная часть конструкции\жизнь\статус
 房 - fáng - дом\комната

体育馆 - tǐ yù guǎn - спортивный зал

健康 - jiàn kāng - здоровье\здоровый
 健 - jiàn - здоровый\укреплять\быть мастером в
 康 - kāng - здоровый\мирный и счастливый\широкий

锻炼 - duàn liàn - заниматься спортом\делать физические упражнения\тренироваться

体育 - tǐ yù - физическое воспитание\спорт\физкультура
 育 - yù - рожать\растить\выращивать\воспитывать\воспитание

运动 - yùn dòng - заниматься спортом\упражняться\спорт
 运 - yùn - перевозить\двигаться\вращаться\удача
 动 - dòng - двигаться\действовать\поддаваться перемещению

流汗 - liú hàn - потеть

跑步 - pǎo bù - бегать трусцой\бегать
 跑 - pǎo - бегать\убегать\ходить\испаряться
 步 - bù - шаг\этап\ситуация\шагать

游泳 - yóu yǒng - плавать
 游 - yóu - путешествовать\странствовать\бродить\скитаться
 泳 - yǒng - плавать
游泳池 - yóu yǒng chí - плавательный бассейн
 池 - chí - пруд\водоем\защищенное место с высокими стенами\ров
跳水 - tiào shuǐ - ныряние\прыжки в воду
 跳 - tiào - прыгать\скакать


轮滑 - lún huá - катание на роликовых коньках
 轮 - lún - колесо\делать что-то по очереди
 滑 - huá - скользить\скользкий\гладкий\хитрый\лукавый

打 - dǎ - бить\ударять\разбиваться\смешивать\совершать действия руками
踢 - tī - пинать\бить ногой

球 - qiú - шарик\мяч\игра в мяч\шар\сфера
篮球 - lán qiú - баскетбол
 篮 - корзина
足球 - zú qiú - футбол
 足 - zú - нога\ступня\достаточный\полный
棒球 - bàng qiú - бейсбол
 棒 - bàng - палка\дубина\замечательный\потрясающий

羽毛球 - yǔ máo qiú - бадминтон\волан для игры в бадминтон 
 羽 - yǔ - перо
 毛 - máo -маленький\грубый\необработанный

排球 - pái qiú - волейбол

网球 - wǎng qiú - теннис\теннисный мяч
 网 - сеть

乒乓球 - pīng pāng qiú - настольный теннис\пинг-понг
橄榄球 - gán lǎn qiú - регби\мяч для игры в регби

滑雪 - huá xuě - ходить на лыжах\кататься на лыжах
滑冰 - huá bīng - кататься на коньках\каток
摔倒 - shuāi dǎo - свалиться\поскользнуться и упасть

写 - xiě - писать\рисовать\сочинять\изображать