方 - fāng - направление\сторона{далекое направление}
 地方 - dì fang - местоположение\пространство\часть\аспект
  地 - dì - земля\почва\Земля\пол\низ\местонахождение\фон\расстояние\

面\边 - mian\bian - {два разных указания стороны, но они одинаковые}{близкое направление}
 上(面\边) - shang - на\прошлый\предыдущий\вышестоящий\верх\подниматься\садиться в машину
 下(面\边) - xià - под\следующий\низ\внизу\спускаться

 前(面\边) - qián - перед\впереди\предшествующее\первый\ пред-\до-\передняя сторона\будущее\раньше\прежде
 后(面\边) - hòu - после\задняя часть\сзади\потомок
 里(面\边) - lǐ - в\внутри
 外(面\边) - wài - вне\снаружи
 旁(面\边) - páng - рядом\около\сбоку
 对(面\边) - duì - напротив\через улицу
 身(面\边) - shēn - около себя\рядом\при себе

 左(面\边) - zuǒ - левый\левый(полит. = революционный)
 右(面\边) - yòu - правый\правый(полит. = консервативный)
 邻近 - lín jìn - быть близко к\прилегать к\по соседству
 属于 - shǔ yú - принадлежать\быть частью

东 - dōng - восток
西 - xī - запад
南 - nán - юг
北 - běi - север

哪里 - ná lǐ - где\куда\откуда\(досл. - который из)
 里 - lǐ - окрестности\родина\родные края

从 - cóng - из\от\с

附近 - fù jìn - близлежащий\находящийся рядом\окрестности\округа
 附 - fù - добавлять\прикреплять\прилагать\приближаться\зависеть от
 近 - jìn - близкий\недалекий\приближаться\подходить

中 - zhōng - середина\центр\внутри

地方 - dì fang - место\местоположение\часть\аспект

距离 - jù lí - расстояние\дистанция\быть отдаленным от
 离 - lí - от(указывает на расстояния)\покидать\оставлять\находиться на расстоянии от

到 - dào - прибывать\добираться\_до_\(указывает на результат действия)