治疗 - zhì liáo - лечить\лечение
 治 - zhì - управлять\контролировать\лечить\уничтожать(вредных насекомых)\учить\изучать\наказывать
 疗 - liáo - лечить\врачевать\исцелять

打喷嚏 - dǎ pēn tì - чихать
鼻涕 - bí tì - сопли


过敏 - guò mǐn - аллергический\иметь аллергию
 过 - guo - (завершенность действия)\пересекать\чрезмерно\слишком\вина\ошибка\чрезмерную степень\превосходство над кем-л./чем-л.
 敏 - mǐn - быстрый\умный\чуткий\восприимчивый
头晕 - tóu yūn - кружится голова\головокружение
 晕 - yūn - головокружение

疼 - téng - испытывающий боль\болезненный\обожать\сильно любить

感冒 - gǎn mào - простудиться\простуда
 感 - gǎn - чувствовать
 冒 - mào - испускать\издавать\подвергаться(риску)

身体 - shēn tǐ - тело\здоровье
 身 - shēn (счетное) тело\(счетное) костюм, комплект
 体 - tǐ - тело\часть тела\масса\форма\система\стиль

(生)病 - (shēng) bìng - заболевать
 病 - bìng болеть\болезнь\дефект\недостаток

头 - tou - голова\шеф\лидер
头发 - tóu fa - волосы
 发 - fà - волосы\отправлять\посылать\стрелять\генерировать\расширять\распространяться\рассеиваться\покидать
胡子 - hú zi - борода\усы
 刮胡子 - guā hú zi - бриться
  刮 - guā - скрести\скоблить\царапать
 剃胡子 - tì hú zi - бриться(разг.)
  剃 - tì - брить
 留胡须 - liú hú xū - отрастить бороду
  留 - liú - оставаться\пребывать\задерживать\сохранять\оставлять
  须 - xū - борода\должно\нужно\следует
脑子 - nǎo zi - мозг\разум
眼睛 - yǎn jing - глаз
 眼 - yǎn - глаз\око\отверстие\глазок\скважина
 睛 - jīng - глазное яблоко
嗓子 - sǎng zi - горло\гортань\голос
耳(朵) - ěr (duo) - ухо
嘴巴 - zuǐ ba - рот
 嘴 - zuǐ - рот\предмет, похожий на рот\слова\язык
 巴 - bā - очень надеяться\ждать с нетерпением\держаться за\автобус\корка
鼻子 - bí zi - нос
心 - xīn - сердце\мысль\настроение\чувство\желание\душа\сердцевина\центр
屁股 - pì gu - зад\ягодицы\попа
 屁 - pì - газы(в кишечнике)\(руг.)чушь, фигня
 股 - gǔ - часть\доля\прядь\бедро
腰 - yāo - поясница\талия\почка\карман\середина
背 - bèi - спина\спинка\задняя часть
脖子 - bó zi - шея
肚子 - dù zi - живот\брюшная полость\желудок

脚 - jiǎo - нога\стопа\основание\ножка
手 - shǒu - рука\умение\мастерство\держать в руке\удобный\портативный\мастер\специалист в какой-то области
手指 - shóu zhǐ - палец руки
 指 - zhǐ - палец\показывать на\указывать\иметь в виду
脚趾 - jiáo zhǐ - палец ноги
 趾 - zhǐ - палец на ноге
肩膀 - jiān bǎng - плечо
 肩 - jiān - плечо\переносить\справляться(с работой)\нести на плечах
 膀 - bǎng - плечо\крыло(птицы)\опухший
膝盖 - xī gài - колено\коленка
 膝 - xī - колено
 盖 - gài - накрывать\заслонять\крышка\колпачок\раковина\панцирь
腿 - tuǐ - нога\опора в форме ножки\окорок\ветчина


牙齿 - yá chǐ - зуб
 牙 - зуб\слоновая кость\предмет в форме зуба
 齿 - зуб\предмет зубчатой формы

脑 - nǎo - мозг\мозги

脸(蛋) - liǎn (dàn) - щеки\лицо
尾巴 - wěi ba - хвост
 (хвост змей)
嘴巴 - zuǐ ba - рот
下巴 - xià ba - подбородок

额头 - é tóu - лоб
眉头 - méi tóu - пространство между бровями\брови
脸 - liǎn - лицо\передняя часть\честь\репутация\выражение лица