第 - dì - {префикс перед порядковым числительным}

数字 - shù zì - цифра\число

零 - líng - ноль
一 - yī - один\одинаковый\весь
二 - èr - два
三 - sān - три
四 - sì - четыре
五 - wǔ - пять
六 - liù - шесть
七 - qī - семь
八 - bā - восемь
九 - jiǔ - девять
十 - shí - десять
百 - bǎi - сотня\много\множество
千 - qiān - тысяча\огромное количество
一万 - yí wàn - десять тысяч

现在 - xiàn zài - сейчас
 现 - xiàn - нынешний\текущий\доступный прямо сейчас\появляться\показываться\с ходу, экспромтом
刚才 - gāng cái - сейчас\только что
 刚 - gāng - только что\как раз\точно\жесткий\колючий\сильный\крепкий
 才 - cái - только что\минуту назад\талант\способность
分钟 - fēn zhōng - минута
 分 - fēn - минута\единица длины, площади или веса\процент\
 балл\оценка\доля\делить\отделять\часть\компонент
 钟 - zhōng - часы\колокол\время\сосредотачивать

时点 - время
 时 - shí - время\годы\сезон\период времени\текущий\мгновенный
 点 - diǎn - час{!моментальное время!}

钟 - zhōng - часы\колокол\время

几点 - сколько времени
小时 - xiǎo shí - час{!продолжительность!}(маленький время)

天 - небо/день
 大前天 - поза-позавчера
 前天 - позавчера
 昨天 - вчера
  昨 - zuó - вчера\прошлое
 今天 - сегодня
  今 - jīn - настоящее время\современный\нынешний\этот\эта\это
 明天 - завтра
  明 - яркий\светлый\зрение\зоркий\ясно видимый\понимать\разъяснять\явный\отчетливый
 后天 - послезавтра
日历 - rì lì - календарь
 日 - rì - день\солнце\дата
 历 - lì - испытывать\проходить через\опыт\один за другим\календарь
生日 - shēng rì - день рождения
 生 - shēng - рождать\расти\возникать\незнакомый\сырой\необработанный\жизнь\
 ученый\ученик
月 - yuè - месяц\луна

时候 - shí hou - период времени\момент (времени)
 候 - hòu - ждать\ожидать\сезон\время\ситуация
 [x]时候[z] ~ когда [x], тогда [z]

以后 - yǐ hòu - после\потом\позже
 以 - yǐ - чтобы\с целью\с помощью\посредством\согласно\потому что

年 - nián - год
 去年 - qù nián - прошлый год
 今年 - этот год
 明年 - будущий год

中午 - zhōng wǔ - полдень
 中 - zhōng - середина\центр\внутри\попадать в\в течение\во время\середина\сердце\разум\Китай
 午 - wǔ - полдень
午夜 - wǔ yè - полночь
 夜 - yè - ночь\вечер

早上 - zǎo shang - утро
 早 - zǎo - ранний\рано\раньше\заранее\уже\давно\утро
晚上 - wǎn shang - вечер\ночь
 晚 - wǎn - поздний\запоздалый\вечер\младший

半个 - bàn gè - половина
 半 - bàn - половина\середина\очень мало\частично

连个 lián gè - пара
 连 - lián - соединять\связывать\рота\батарея\эскадрон\включая

差 - chà - отличаться\недоставать\отсутствовать\неправильный\плохой\разница\слегка\едва

号码 - hào mǎ - номер(напр., комнаты, телефона и т.д.)
 号 - hào - приказ\номер\размер\дата\приказ\горн\знак\сигнал\
 прозвище\псевдоним\титул\название(компании)\кричать\вопить\реветь
 码 - mǎ - ярд\знак\код\инструмент\складывать кучей\нагромождать
星期 - xīng qī - неделя
 星 - xīng - звезда\небесное тело\знаменитость\частица\искра
 期 - qī - период(времени)\назначенное время\назначать встречу\ожидать
  星期日 - какой день месяца
  星期几 - какой день недели
  星期[число] - соответствующий день недели
  星期天 - воскресенье

周[число] - zhōu [число] - соответствующий день недели
周日 - zhōu rì - сущ воскресенье

未来 - wèi lái - будущее\будущий\предстоящий\(букв. - еще не случившийся)
 未 - не\не-
 来 - приходить\происходить\наступать\следующий

正负 - zhèng fù - плюс-минус
 正 - zhèng - точно\именно когда\приводить в порядок\честный\законный\(матем. и физ.)положительный\
 стандартный\фронтальный\лицевой\пунктуальный
 负 - fù - нести\подвергаться\проигрывать\задолжать\(матем.)минус\(электр.)отрицательный\
 нести(на спине)\полагаться на\опираться на\пользоваться\предавать\нарушать

多久 - duō jiǔ - как долго\как часто
 久 - jiǔ - долгий\определенная продолжительность

最近 - zuì jìn - недавно\в последнее время
 最 - zuì - самый\первый\лучший
 近 - jìn - близкий\недалекий\близкий(об отношениях)\приближаться

一直 - yì zhí - прямо\прямиком\всегда\все время\постоянно
 直 - zhí - выпрямлять\прямой\вертикальный\справедливый\непрерывно
经常 - jīng cháng - ежедневный\повседневный\часто\постоянно
 经 - jīng - проходить через\испытывать
 常 - cháng - часто\обычный\обыкновенный\постоянный\закон\дисциплина

马上 - mǎ shàng - немедленно\прямо сейчас(досл. - лошадь подниматься)
立刻 - lì kè - сразу же\немедленно

上旬 - начало месяца
中旬 - середина месяца
下旬 - конец месяца
 旬 - xún - десять дней\декада\десять лет\десятилетие

周末 - zhōu mò - конец недели\выходные\выходной
