旅游 - lǚ yóu - путешествовать\совершать поездку
 旅 - lǚ - путешествие\путешественник
 游 - yóu - путешествовать\странствовать\бродить\скитаться

收拴 - shōu shuān - прибирать\приводить в порядок
 收 - shōu - получать\принимать\собирать\собирать урожай\сдерживать\завершать
 拴 - shuān - привязывать\прикреплять

打扫 - dá sǎo - подметать\прибирать
 扫 - sǎo - мести\подметать\устранять\метла

钓鱼 - diào yú - удить рыбу\ходить на рыбалку
 钓 - рыбачить

写 - xiě - писать\рисовать\сочинять\описывать\изображать

庆祝 - qìng zhù - праздновать

荡秋千 - dàng qiū qiān - качаться на качелях
 荡 - качать\колыхать\блуждать
 秋 - осень\смутное время\время сбора урожая\качели
 千 - тысяча\огромное количество

休息 - xiū xi - отдыхать

学习 - xué xí - учиться\учить

上学 - shàng xué - ходить в школу\учиться в школе

唱歌 - chàng gē - петь песню\ходить в караоке-бар
 唱 - chàng - петь\кричать\выкрикивать
 歌 - gē - песня\мелодия\петь\хвалить\воспевать

读书 - dú shū - читать(книгу)\ходить в школу\учиться

教 - jiāo - учить\обучать\преподавать

接触 - jiē chù - соприкасаться\контактировать
 接 - jiē - контактировать
 触 - chù - дотрагиваться\касаться

跳舞 - tiào wǔ - танцевать\плясать
 跳 - tiào - прыгать\скакать\отскакивать\биться\пульсировать
 舞 - wǔ - танцевать\размахивать\танец