计划 - jì huà - планировать\план
 计 - jì - считать\подсчитывать\планировать\идея\план\счетчик\датчик
 划 - huà - черта\чертить\царапать\стоящий\грести\разграничить

放了 - fàng le - положить (что-то) в\освободить (кого-то)
 放 - fàng - класть\помещать\испускать\освобождение\освобождать\увеличивать\валить\передавать

分心 - fēn xīn - отвлекаться\рассеивать внимание
 心 - xīn - сердце\мысль\настроение\чувство\душа\сердцевина\центр
 分 - fēn - минута\делить\отделять\\оценка\доля

尝试 - cháng shì - пробовать\пытаться
 尝 - cháng - пробовать(обычно пищу)\испытывать
 试 - shì - пробовать\примерять\испытывать\экзаменовать
企图 - qǐ tú - пытаться\попытка
 企 - qǐ - предприятие\компания\ждать с нетерпением\вставать на цыпочки
 图 - tú - рисунок\искать\стремиться\добиваться\продумывать план\
 рисовать\план\схема\карта\чертёж\замысел

做 - zuò - делать\заниматься\изготавливать

玩 - wán - развлекаться\играть; использовать, прибегать к 

使用 - shǐ yòng - использовать\применять

送 - sòng - дарить

想 - xiǎng - думать\размышлять\желать\предполагать\скучать

猜对 - cāi duì - угадать\отгадать
 猜猜 - гадать\угадывать\отгадывать

听 - tīng - слышать\слушать\повиноваться\звучать

买 - mǎi - покупать
卖 - mài - продавать; предавать; не жалеть усилий; хвастаться; зарабатывать на жизнь своим навыком

读 - dú - читать вслух\читать\произношение(иероглифа)

(打)开 - (dǎ) kāi - открывать\включать
 打 - dǎ - бить\ударять\разбиваться\атаковать\звонить(по телефону)\
 стрелять\играть(руками)\
 с\из\от\через\
 делать\готовить(еду)
 开 - kāi - открывать\включать\водить(автомобиль)\проводить(собрание)\
 проделывать\прокладывать\осваивать(земли)

关(闭) - guān (bì) - закрывать\запирать\выключать
 关 - guān - закрывать\затворять\выключать(технику)\
 таможня\препятствия\засов\щеколда\
 критический момент\решающий рубеж
 闭 - bì - закрывать\завершать\блокировать\препятствовать

叫 - jiào - кричать\называть(ся)\звать\вызывать

哭 - kū - плакать
笑 - xiào - смеяться\улыбаться\высмеивать\насмехаться над

找 - zhǎo - искать
 找到 - zhǎo dào - найти
  到 - dào - прибывать\добираться\внимательный\предусмотрительный\
  (используется после глагола и указывает на результат действия)

剪 - jiǎn - подстригать\обрезать(ножницами)\ножницы\вырезать\уничтожать

下来 - xià lái - спускаться\выходить\сходить\(букв. - вниз прибывать)

换 - huàn - менять\обменять\конвертировать

选(择) - xuǎn (zé) - выбирать\выбор
 选 - xuǎn - выбирать\избирать\выбранный человек или вещь\собрание\антология\выборка
 择 - zé - выбирать\отбирать'

看见 - kàn jiàn - видеть\увидеть
 看不见 - не видеть

起床 - qǐ chuáng - вставать\подниматься(с кровати)
 起 - qǐ - с\подниматься\вставать\начинаться\разразиться\строить
躺下 - xià - ложиться\ложиться спать
 躺 - tǎng - лежать\ложиться
睡着 - shuì zháo - спать\во сне\засыпать
 睡 - shuì - спать

加 - jiā - добавлять\увеличивать
减 - jiǎn - уменьшать\сокращать\вычитать\отнимать\минус

发 - fā - отправлять\посылать

拿 - ná - брать\держать\хватать\быть уверенным\притворяться(вводит инструментальное дополнение)с помощью

进来 - jìn lái - входить\заходить
 进 - jìn - входить\подавать\поступать на службу\получать\(после глагола указывает на направление действия внутрь)
过来 - guò lai - подходить\приходить

出来 - chū lái - двигаться изнутри наружу\выходить(в направлении говорящего)\возникать\заканчивать\завершать
 出 - chū - выходить\превышать\выдавать\появляться\присутствовать
出去 - chū qù - выходить
 去 - qù - идти\ехать\отправляться из\теряться

回来 - huí lái - возвращаться\приходить обратно
 回 - huí - возвращаться\поворачивать\разворачивать\вращаться\кружить

开始 - kāi shǐ - начинать(ся)\начало
 开 - kāi - открывать\включать\водить(автомобиль)
 始 - shǐ - начинать\начало

下班 - xià bān - закрываться\заканчивать смену\уходить с работы
 班 - bān - команда\группа\класс\(рабочая)смена\бригада\рейс\маршрут\вахтовый\дежурный; расставлять по ранжиру

分开 - fēn kāi - делить\отделять\разделять\расставаться

清理 - qīng lǐ - привести в порядок\вычистить\распутать\упорядочить

关上 - guān shàng - закрыть
 关 - guān - закрывать\затворять\выключать(технику)\таможня

进 - jìn - входить\идти вперед\подавать\поступать на службу\получать

剪 - jiǎn - подстригать\обрезать(ножницами)

打扫 - dá sǎo - глаг подметать, прибирать

说了 - сказал

盖 - gài - накрывать\заслонять\крышка\колпачок

介绍 - jiè shào - представлять\знакомить
 介 - jiè - (знакомить\используется в многосложных словах)
 绍 - shào - продолжать\наследовать

切 - qiē - резать\разрезать\(матем.)касаться

帮(助) - bāng (zhù) - помогать\способствовать

尿尿 - niào niào - (неформ)писать,мочиться
 尿 - niào - моча\мочиться

照顾 - zhào gù - заботиться о\ухаживать за

等 - děng - ждать

飞 - fēi - летать\витать(в воздухе)\улетучиваться

强调 - qiáng diào - подчеркивать\акцентировать

醒 - xǐng - проснуться\пробудиться\очнуться\бодрствовать\осознавать

写 - xiě - писать\рисовать\сочинять(музыкальное или литературное произведение)

骂 - mà - ругать\бранить\осуждать\упрекать

抽烟 - chōu yān - курить\курить сигарету

陪伴 - péi bàn - сопровождать\составлять компанию

花 - huā - тратить\расходовать
 花了 - потратил

述 - shù - излагать\повествовать

流淌 - liú tǎng - (о жидкости)течь\бежать

让 - ràng - разрешать\позволять\заставлять\освобождать путь для\пропускать

告诉 - gào su - скажи

算 - suàn - считать\вычислять
擦 - cā - мыть\тереть\натирать(на терке)\протирать
倒 - dào - наливать\переворачивать\давать задний ход

重覆 - chóng fù - повторить\дублировать

生 - shēng - рождать\расти\возникать\создавать\разжигать(огонь)

做 - zuò - делать\заниматься\изготавливать\производить\писать\сочинятьj